56 6 50
00000000000000000000000000000000000000000000000000000004
00000300000000300000000050000000000000000000000000000000
00003330033300000500300000030000030000000300000000003300
01033330330030000000003000000000300000000000000003300000
22222222222222222222222222222222222220002222222222222222
22222222222222222222222222222222222222202222222222222222