56 7 50
00000000000000000000000000000000000000000000000000000000
00000000000000000333000000000000000000000000000000000000
00000300000003300000033300030000000300000000000000000000
00003330033300000003000000333000000000030000000000000400
01533330333330005000000003333353350033000003335000000000
22222222222222222200222222222222222222222222222222222222
22222222222222222200222222222222222222222222222222222222