56 6 50
00000000000000000000000000000000000000000000000000000004
00000300000000300000000050000000000000000000300000000000
00003330033300000500300000030000030030300300300000003300
01033330330030000000003000000000303000000000300003300000
22222222222222222222222222222222222220000000222222222222
22222222222222222222222222222222222222222222222222222222